{
  "levels": {
    "level1": [
      [1,1,1,2,1,1,1,1,1,1,1,1,1,1,1],
      [1,0,0,0,0,0,0,0,0,0,0,0,0,0,1],
      [1,0,0,0,0,0,0,0,0,0,0,0,0,0,1],
      [1,0,0,0,0,0,0,0,0,0,0,0,0,0,1],
      [1,0,0,0,0,0,0,0,0,0,0,0,0,0,1],
      [1,0,0,0,0,0,0,0,0,0,0,0,0,0,1],
      [1,0,0,0,1,0,0,0,0,1,1,0,0,0,1],
      [1,0,0,1,1,1,1,0,1,1,0,0,0,0,1],
      [1,0,0,0,0,1,0,0,1,1,0,0,0,0,1],
      [1,0,0,0,0,0,0,0,1,1,1,0,0,0,1],
      [1,0,0,0,0,0,0,0,0,0,0,0,0,0,1],
      [1,0,0,0,0,0,0,0,0,0,0,0,0,0,1],
      [1,0,0,0,0,0,0,0,0,0,0,0,0,0,1],
      [1,0,0,0,0,0,0,0,0,0,0,0,0,0,3],
      [1,1,1,1,1,1,1,1,1,1,1,1,1,1,1]]
  },
  "tiles": {
    "0": "tile",
    "1": "border",
    "2": "start",
    "3": "end"
  }
}